0000000000000000000000000000000000-
0000000000000000000000000000000000-
0000000000000000000000000000000000-
0000000000000000000000000000000000-
0000000000000000000000000000000000-
0000000000000000000000000000000000-
0000000000000000000000000000000000-
0000000111112111111121111110000000-
0000000131333333133333333310000000-
0000000131311111131111111310000000-
0000000131313333333333131310000000-
0000000231313111113113131320000000-
0000000133313133313313133310000000-
0000000131333131313111111310000000-
0000000131313131313333331310000000-
0000000131113131313111131310000000-
0000000133333131313333131310000000-
0000000231111131113111131320000000-
0000000131333333333313331310000000-
0000000131111111111311111310000000-
0000000133333333333333333310000000-
0000000111112111111112111110000000-
0000000000000000000000000000000000-
0000000000000000000000000000000000-
0000000000000000000000000000000000-
0000000000000000000000000000000000-
0000000000000000000000000000000000-
0000000000000000000000000000000000-
0000000000000000000000000000000000