0000000000000000000000000000000000000000-
0000000000000000000000000000000000000000-
0000000000000000000000000000000000000000-
0000000000000000000000000000000000000000-
0000000000000000000000000000000000000000-
0000000000000000000000000000000000000000-
0000000000000000000000000000000000000000-
0000000111111112111111121111111110000000-
0000000144111113111111131111114410000000-
0000000144131333333133333333314410000000-
0000000111131311111131111111311110000000-
0000000111131313333333333131311110000000-
0000000233331313111113113131333320000000-
0000000111133313133313313133311110000000-
0000000111131333131313111111311110000000-
0000000111131313131313333331311110000000-
0000000111131113131313111131311110000000-
0000000111133333131313333131311110000000-
0000000233331111131113111131333320000000-
0000000111131333333333313331311110000000-
0000000144131111111111311111314410000000-
0000000144133333333333333333314410000000-
0000000111111113111111113111111110000000-
0000000111111112111111112111111110000000-
0000000000000000000000000000000000000000-
0000000000000000000000000000000000000000-
0000000000000000000000000000000000000000-
0000000000000000000000000000000000000000-
0000000000000000000000000000000000000000-
0000000000000000000000000000000000000000-
0000000000000000000000000000000000000000