000000000000000000000000000000000000000000000-
000000000000000000000000000000000000000000000-
000000000000000000000000000000000000000000000-
000000000000000000000000000000000000000000000-
000000000000000000000000000000000000000000000-
000000000000000000000000000000000000000000000-
000000000000000000000000000000000000000000000-
000000000000111111211111112111111100000000000-
000000000001111111311111113111111110000000000-
000000000011413133333313333333331311000000000-
000000000114413131111113111111131331100000000-
000000001111113131333333333313131333110000000-
000000011333333131311111311313133333110000000-
000000011333313331313331331313331333110000000-
000000022333313133313131311111131333220000000-
000000022333313131313131333333131333220000000-
000000022333313111313131311113131333220000000-
000000011333333333313131333313131333110000000-
000000011333313111113111311113131333110000000-
000000001111113133333333331333133333110000000-
000000000114413111111111131111131331100000000-
000000000011413333333333333333331311000000000-
000000000001111111311111111311111110000000000-
000000000000111111211111111211111100000000000-
000000000000000000000000000000000000000000000-
000000000000000000000000000000000000000000000-
000000000000000000000000000000000000000000000-
000000000000000000000000000000000000000000000-
000000000000000000000000000000000000000000000-
000000000000000000000000000000000000000000000-
000000000000000000000000000000000000000000000