000000000000000000000000000000000000000000000-
000000000000000000000000000000000000000000000-
000000000000000000000000000000000000000000000-
000000000000000000000000000000000000000000000-
000000000000000000000000000000000000000000000-
000000000000000000000000000000000000000000000-
000000000000000000000000000000000000000000000-
000000000000000111111222111111100000000000000-
000000000000001111111333111111110000000000000-
000000000001111111111113333333311110000000000-
000000000015411111111111111111311451000000000-
000000000114413333333333333333331441100000000-
000000001111111111111111111111131111110000000-
000000011111113333333333333333331111110000000-
000000011111113111111111111111111111110000000-
000000023333333133311133331333131113320000000-
000000023311113131311331131313131113320000000-
000000023311113131313311131313133333320000000-
000000011111113131313111131313131111110000000-
000000011111113331333111133313131111110000000-
000000001111111111111111111113131111110000000-
000000000114413333333333333333131441100000000-
000000000015411131111111111113331451000000000-
000000000001111131111111111111111110000000000-
000000000000001133333333311111110000000000000-
000000000000000111111222211111100000000000000-
000000000000000000000000000000000000000000000-
000000000000000000000000000000000000000000000-
000000000000000000000000000000000000000000000-
000000000000000000000000000000000000000000000-
000000000000000000000000000000000000000000000-
000000000000000000000000000000000000000000000-
000000000000000000000000000000000000000000000