000000000000000000000000000000000000000000000-
000000000000000000000000000000000000000000000-
000000000000000000000000000000000000000000000-
000000000000000000000000000000000000000000000-
000000000000000000000000000000000000000000000-
000000000000000000000000000000000000000000000-
000000000000000000000000000000000000000000000-
000000000000000111111222111111100000000000000-
000000000000001111333333333111110000000000000-
000000000001111111311111113111111110000000000-
000000000011413333333333333333331411000000000-
000000000114513131111111111113131541100000000-
000000001111113131333333333313131111110000000-
000000011333333131311111311313131333110000000-
000000011311313331313331331313331113110000000-
000000022333313133313131311311133333220000000-
000000022311113131313131333333131113220000000-
000000022313313131313131311113131333220000000-
000000011311333333313131333333131313110000000-
000000011333313111113111311113133333110000000-
000000001111113333333333333333331111110000000-
000000000114513111111111111111131541100000000-
000000000011413333333333333333331411000000000-
000000000001111111311111111311111110000000000-
000000000000001111333333333311110000000000000-
000000000000000111111222211111100000000000000-
000000000000000000000000000000000000000000000-
000000000000000000000000000000000000000000000-
000000000000000000000000000000000000000000000-
000000000000000000000000000000000000000000000-
000000000000000000000000000000000000000000000-
000000000000000000000000000000000000000000000-
000000000000000000000000000000000000000000000